20 2
10 5
25 10
30 15
40 20
80 0
7 10
U-+...+--+
|.@...|..|
+-+-U-+..S
|.|...B..|
S.|...GS-+
|.|......|
+-T------+