10 0
10 30
120 0
120 0
10 10
130 0
6 10
@-+T+S+S-+
|.B.|.|..T
+U+-B-U--+
|.|.|.|..U
|.B.|.B..|
+-+-T-+--G