30 1
15 5
25 10
15 5
40 15
100 0
15 15
+--+...T---+--+
|..|...|...|..|
|..|...|...B--+
|..G--++......|
|.....|.......|
|.....|.......|
S-----+-------B
|.....+-----+.|
|.....|.....|.|
|.....+--U--+.|
|........|..|.|
|........|..|.|
+---@----+--+.|
|...|.......|.|
T---+-------+-S
